DEPT_ID,2003,2004,2005,2006,2007,2008,2009,2010,2011,2012,2013,2014
1,6866,6706,6976,7228,6949,7323,7157,7282,7265,7242,7296,7354
2,6841,6761,6889,7041,6847,7012,6941,7050,6939,6755,6559,6468
3,3391,3335,3363,3503,3277,3289,3308,3402,3196,3288,3198,3152
4,1460,1522,1514,1536,1569,1569,1513,1547,1578,1561,1629,1538
5,1408,1403,1395,1461,1448,1441,1513,1470,1399,1441,1406,1383
6,11144,11514,11631,11754,11633,12275,11949,12257,11999,12087,12149,12170
7,3367,3176,3414,3484,3484,3447,3307,3380,3360,3405,3179,3254
8,3532,3422,3420,3343,3552,3522,3312,3254,3137,3258,3021,2966
9,1350,1412,1389,1499,1570,1493,1452,1473,1404,1425,1413,1364
10,3428,3553,3692,3685,3619,3721,3745,3722,3635,3587,3436,3377
11,3421,3321,3502,3661,3723,3778,3797,3770,3789,3669,3618,3516
12,2558,2614,2701,2829,2769,2748,2640,2694,2682,2615,2475,2555
13,23908,24056,24411,25371,25126,25412,25547,26410,25889,26328,26762,26384
14,8231,8257,8251,8531,8310,8183,8304,8111,8041,7833,7644,7466
15,1344,1396,1391,1398,1357,1300,1377,1274,1237,1230,1290,1214
16,3401,3514,3570,3653,3618,3666,3408,3564,3459,3490,3472,3378
17,5935,5900,6069,6089,5903,6136,6209,6185,6065,5916,5778,5846
18,3301,3271,3313,3231,3341,3303,3229,3341,3159,3120,3128,3097
19,2133,2250,2319,2327,2245,2263,2231,2247,2196,2163,2055,2094
21,6079,6052,5844,5986,6015,5960,5852,5963,5906,5905,5769,5779
22,6413,6317,6287,6743,6473,6494,6559,6438,6221,6184,5927,5790
23,1011,957,1054,1038,1013,1029,1044,919,967,998,897,879
24,3607,3690,3662,3758,3760,3832,3672,3665,3645,3547,3486,3479
25,6529,6798,6782,6993,6804,7097,6914,7105,6826,6778,6732,6659
26,5525,5703,5579,5945,5833,5927,5846,5915,5978,5912,6026,5965
27,7213,7220,7386,7402,7471,7717,7714,7715,7738,7676,7352,7242
28,5370,5363,5585,5632,5440,5677,5573,5716,5540,5548,5312,5295
29,9900,9963,9851,10184,9962,10040,9733,9823,9615,9597,9277,9088
30,7446,7777,7901,8384,8190,8449,8354,8494,8467,8196,8427,8216
31,13989,13900,14233,14957,14968,15415,15317,15770,16031,16347,16290,16641
32,1635,1625,1666,1580,1669,1689,1718,1671,1587,1668,1648,1643
33,15610,15819,15722,16539,16514,16636,17072,17271,17098,17097,17265,17303
34,11380,11562,11636,12191,12252,12564,12531,12658,13000,12902,12899,13008
35,12134,12072,12405,12687,12606,12837,12917,12876,13033,12892,12729,12555
36,2312,2314,2394,2283,2341,2371,2178,2221,2137,2136,2006,2030
37,6620,6594,6644,6813,6434,6811,6828,6886,6696,6796,6594,6718
38,14885,15356,15447,15830,15646,15999,15916,16136,15739,15948,15724,15664
39,2964,3017,2924,3021,3037,3045,2897,2865,2758,2741,2675,2637
40,3477,3621,3574,3755,3953,3862,3914,3993,3853,3880,3864,3696
41,3617,3678,3724,3815,3752,3847,3786,3777,3667,3704,3581,3517
42,8804,8906,8975,9184,9222,9357,9174,9403,9357,9473,9086,9183
43,2458,2416,2485,2426,2301,2398,2390,2348,2300,2244,2247,2157
44,15795,15988,16301,16530,16664,16763,16766,17159,16747,16821,16822,16700
45,8265,8424,8200,8635,8644,8524,8499,8757,8686,8689,8526,8355
46,1537,1430,1477,1563,1511,1555,1435,1506,1423,1487,1345,1415
47,3173,3245,3341,3426,3399,3378,3445,3359,3397,3332,3361,3347
48,768,772,760,784,781,779,798,736,695,711,663,651
49,10018,10085,10148,10548,10227,10270,10165,10312,10320,10061,10016,9781
50,5490,5487,5538,5448,5356,5384,5231,5238,5193,5282,4998,4911
51,6916,6979,7108,7118,6932,7065,7061,7182,7070,6761,7000,6887
52,2100,2095,2029,2104,2062,2037,1944,1889,1916,1847,1923,1881
53,3846,3932,3981,4118,3835,3912,3897,3962,3733,3750,3656,3456
54,8398,8671,8542,8743,8421,8559,8487,8536,8499,8387,8197,8135
55,2218,2287,2158,2294,2296,2220,2122,2221,2119,2107,2070,1928
56,7817,8036,7802,8221,7968,8288,7942,8029,7894,7909,7645,7554
57,11710,11970,12048,12114,11853,12012,11831,11856,11474,11579,11421,11385
58,2123,2181,2115,2137,2151,2049,1986,1982,1999,1942,1850,1801
59,36099,36257,35960,36858,36531,36572,36508,36703,36678,36513,36354,35923
60,10696,10630,10753,11144,11097,11162,11013,10960,11032,10941,10814,10802
61,3323,3243,3117,3276,3316,3185,3248,3192,3105,2933,2834,2810
62,18888,19304,19407,19780,19668,19902,19661,19784,19720,19017,19054,18809
63,6576,6632,6701,6902,6896,6865,6774,7131,6828,6933,6699,6908
64,6436,6338,6395,6680,6288,6455,6652,6569,6459,6490,6269,6497
65,2144,2186,2095,2284,2266,2095,2161,2149,2110,2201,2057,2111
66,4456,4320,4563,4779,4638,4756,4837,4869,4843,4943,4914,4800
67,13024,12828,13195,13388,13152,13231,13218,13346,13030,12895,13043,13262
68,9045,8945,8912,9324,8941,8909,8938,9177,8927,8818,8713,8826
69,23376,23796,24270,24808,24465,25120,25528,25973,25921,26294,25914,26712
70,2675,2773,2827,2975,2888,2755,2785,2761,2643,2609,2510,2458
71,5717,5709,5789,5876,5736,5860,5838,5865,5811,5752,5514,5552
72,6871,6935,6770,7133,6808,6909,6957,6942,6810,6703,6645,6664
73,4687,4736,4795,4903,5000,4971,4863,5074,4917,4786,4762,4798
74,8839,8753,8967,9124,8939,9333,9271,9521,9476,9829,9893,9982
75,31493,31817,31378,31748,30820,30623,31063,31447,30094,29291,28945,29134
76,15862,15650,15691,16004,16066,16041,15947,16338,16146,16014,15574,15199
77,17501,17729,18317,18986,18978,19240,19331,19712,19824,19678,19331,19708
78,19937,19431,19766,20438,19899,19895,19868,20312,19886,19827,19886,19525
79,3994,4100,4191,4057,4037,4331,4157,4060,4006,4029,3986,3718
80,7134,7035,7024,7021,6939,7094,6838,7103,6989,6843,6743,6506
81,3579,3611,3837,3933,3869,4056,4030,3925,4006,3939,3829,3831
82,2398,2591,2590,2823,2858,2932,2935,2926,2978,2940,2827,2829
83,10388,10622,10646,10889,10938,11131,10955,11159,11146,11240,10917,11123
84,6547,6629,6608,6805,6694,7000,7014,6967,7008,7107,7171,7058
85,6874,7062,7299,7589,7647,7629,7718,7601,7442,7436,7164,7070
86,4594,4568,4725,4850,4753,4909,4953,5006,4885,4880,4708,4686
87,3449,3659,3834,3754,3829,3891,3985,3848,3907,3825,3723,3724
88,4291,4264,4310,4416,4274,4215,4252,4057,3883,3715,3796,3679
89,3710,3844,3821,3929,3917,4045,3991,3842,3699,3729,3780,3621
90,1896,1766,1837,1888,1880,1818,1822,1802,1794,1763,1675,1707
91,17122,17614,17753,18281,17932,18134,18040,18509,18493,18506,18510,18903
92,24607,24649,24588,25426,24937,25217,25192,25194,25083,24790,24614,24675
93,25868,26313,26760,27916,27743,28062,28313,28513,28362,28675,28687,29471
94,19637,19866,19947,20948,20331,20736,21022,21391,20991,20967,20748,21566
95,17346,17863,18012,19015,18624,18761,18728,19506,19551,19495,19550,19737
96,1232,1228,1348,1337,1284,1370,1422,1408,1422,1398,1317,1371
97,1455,1444,1525,1474,1564,1569,1580,1591,1662,1612,1599,1616